########################################
#++++°+°°++H+++++++++++X++H+++++°++++++#
#+R++°+++++H+++°X+++++++++H+++++X°+++++#
#+++++°++++°+++@ +++H+@ ++H++++++++++++#
#°+°++°++++++++  +++H+  ++H++++°+++++++#
#°°+++°°++++++++++++H+++++++++°°++X++++#
#+++++++X++H+++X++++H+++X++++++°+++++++#
#+X+HHHHHHHHHHHHHHHHHHHHHHHHHHHHHHHH+++#
#+++++++°°++H+++++++++H++++++++++++++++#
#++°++X+++++H+++++++++H+++°°+++++++++X+#
#+°°°°+++++++++++@ +++H++++X+++++++++++#
#++°+++++++++++++  ++++++++++++H+++HHHH#
#+++W°++++++H++++++++++++++++++H++++°++#
#++++°++++++H+++++X++++++++++++H++++X++#
#HHHHHHHHHHHHHHHHHHHH++X++HHHHHHHHHHHHH#
#+°+++++°+++++H++++++++++++++H+++++++++#
#+++++++++++++H++++++++++++++++++++++++#
#+X+°+++°°++++H+++°°++++°++++H++++X+++E#
#+++°°++++++++++++++++++°°+++H+++++++++#
########################################