########################################
#+++++++++++°°°++++++++++++++°+++++++++#
#+R+++++++++°X+++++++++++++++X°++++++++#
#++++++++++++++++++++++++++++++++++++++#
#HHHHHHHHHHHHHHHHHHHHHHHHHHHHHHHHHH++++#
#+X+++°°+++++++H++°++X+++°°++++++++++++#
#++++++++++++++H++°++++++++++++++++++++#
#+++++@ +++++++H+++++++++@ +++++°°°°+++#
#+++++  +++++++X+++++++++  +++++°++X+++#
#++++++++++++++++++++°°X°°°++++++++++++#
#HHHH+++++HHHHHHHHH+++++++++++HHHHHHHHH#
#++++++++H+++++°+++++++++++++++++°°++++#
#+X++++++H+++°°+°+++++++X++++++++++++++#
#HHHH++++H+++++W+++++HHHHHHHHH+++@ ++++#
#X+++++++H+++++++++++++++++++++++  +X++#
#HHHHHHHHHHHHHHHHHHHH+++@ ++++HHHHHHHHH#
#++++++++++++X°+++++++++  +++++++°+++++#
#+E++++++++++°++++++++++++++++H++°+X+++#
#+++++++++++++++++++++++++++X+H++++++++#
########################################