########################################
#++++++++++++++°°°++++++++++X++++++++++#
#+R+++++++++++++X++++++++H+++++++++++++#
#HHHHHHHHHHHHHHHHHHHHHHHHHHHHHHHHHHH+X+#
#++++++++++++++++°++°°+++++++++++++++++#
#+++++++++++++++°X+++++++++++++++++++++#
#+++++++X+++°°++++++++++++++++X++++++++#
#+++++++++++°++++++++++++++++++°°++++++#
#+++++++++++++HHHHHHHHHH+++++++++++++++#
#+++++++++++++H++++++++H+++++++@ ++++++#
#+°°°+++H+++++++++E°°++H+++++++  ++++++#
#+++X+++H++++++++++++++H+++++++++++++++#
#+++++++H++++++X+++@ ++H+++++++X+++++++#
#+++++++H++++++++++  ++++++++++++++++++#
#HHHHHHHHHHHH++++++++++++++++++++++++++#
#++++++++++++X++++°°°++++++++++°+++++++#
#++°+++++++++++++++++++++H++++°X°++++++#
#++X°++++++++++++++W+++++H+++++°+++++++#
#++++++++++++++++++++++++H+++++++++++++#
########################################