########################################
#+++++++H°°++++++++++++++H°°+++++++++++#
#+R+++++H@ ++++++++++++++H++++++X++++++#
#+++++++H  ++++++++++++++H@ +++++++++++#
#HHHHHHHH++++++++++++++++H  +++++++++++#
#+++++++++++HHHHHHHHHHHHHH+++++++++++X+#
#+++++++++++H++++++++++++++++++°°++++++#
#+++HHHHHHHHH++++++°++++++++H++XX°°HHHH#
#++++°°+++++H++++++X°+++++++H++++++++++#
#+++++++++++H+++++++++°°°+++H++++@ ++++#
#++++@ +++++H+++++++++++++++H++++  ++++#
#++++  +++X+H++++++++++W++++H++++++++++#
#HHHHHHHHHHHH+++++HHHHHHHHHHHHHHHHH++X+#
#+++++++++++++++++H++++++++++++++++++++#
#+++X+++++++++++++H+++++++++++HHHHHHHHH#
#++++++++°°°°°++++H++++++°°+++H°°++++++#
#+++++++++++++++++H++++++XX++++++++++++#
#++++++++++W++++++H+++++++++++H@ ++++E+#
#+++++++++++++++++H+++++++++++H  ++++++#
########################################