########################################
#+++++++++X++++++++++++++++++++H+++++++#
#+R++++++++++++++++++++°°++++++H++++E++#
#++++HHHHHHHHHHHH++++++++++++++H+++++++#
#+X+H+++++X+++++H++++++@ ++++++H+++++++#
#+++H+++HHHHH+++H++++++  ++++++H+++++++#
#+++H+++H+++H+++H++++++X+++++++H+++X+++#
#+++H+++H+X+H+++H++++++++++++++H+++°°++#
#+++H+++++++H+++H++++°°°°°°++++H+++@ ++#
#+++HHHHHHHHH+X+H++++++++++++++H+++  ++#
#+++X+++°°°+++++H+++++++W++++++H+++++++#
#+++++++++++++++H++++++++++++++H+++++++#
#HHHHHHHHHHHHHHHHHHHH+++°°°++++HHH+X+HH#
#++++++++++++++++++++++++X++++H++++++++#
#++++++++++++++++++++++++++++H+++++++++#
#+++++++++++HHHHHHHHHHHHHHHHH+++°°°°°++#
#+°++H++++++++°+°+++++°°++++H++++++++++#
#+X°+H++++++++++++++++°°+++H+++++W+++++#
#++++H++++++++@   ++++++++++X++++++++++#
########################################